Is Rome the capital of Italy?	WorldGeography
Is France in Europe?	WorldGeography
Is the Pacific deeper than the Atlantic?	WorldGeography
Did Neeson star in Schindler’s List?	oscar-movie_imdb
Did Swank win the oscar in 2000?	oscar-movie_imdb
Is the Shining by Kubrik?	oscar-movie_imdb
Did a French actor win the oscar in 2012?	oscar-movie_imdb
Did a movie by Spielberg with Neeson win the oscar for best film?	oscar-movie_imdb
Did Madonna sing PapaDoNotPreach?	music
Does the album Thriller include the track BeatIt?	music
Was Beyonce’ born in the USA?	music
Who directed Hugo?	oscar-movie_imdb
Which is the scary movie by Kubrik with Nicholson?	oscar-movie_imdb
Who won the oscar for the best actor in 2005?	oscar-movie_imdb
Which actress won the oscar in 2012?	oscar-movie_imdb
Who directed the best movie in 2010?	oscar-movie_imdb
In which continent does Canada lie?	WorldGeography
What is the capital of Spain?	WorldGeography
With which countries does France have a border?	WorldGeography
Which is the highest mountain in the world?	WorldGeography
Where is the highest mountain?	WorldGeography
Which is the deepest ocean?	WorldGeography
Which pop artist sings CrazyInLove?	music
Where was Gaga born?	music
In which album does Aura appear?	music
Which album by Swift was released in 2014?	music
which song did taylor swift sing?	music
